111111111111111
100C000000000E1
100000000000001
1000P000000C001
100000000000001
100C00000000C01
111111111111111