1111111111111111111111111111111111111111
1000000000000000000000C00000000000000001
100C000000000E00000000000000000000000001
100000000000000000000000000000000C000001
1000P000000C0000000000000000000000000001
1000000000000000000000000000000000000001
100C00000000C000000000000000000000000001
1000000000000000000000000000000000000001
1000000000000000000000000000000000000001
1000000000000000000000000000000000000001
1000000000000000000000000C00000000000001
100000C000000000000000000000000000000001
1000000000000000000000000000000000000001
10000000000000000000000000000000C0000001
1000000000000000000000C00000000000000001
100000000000000000000000000C000000000001
100000000C000000000000000000000000000001
10000000000000000000000000000000C0000001
1000000000000000000000000000000000000001
1111111111111111111111111111111111111111