11111111
10000C01
10000001
10000001
1000P0E1
11111111