11111111
10000C01
10C00001
10P00001
100000E1
11111111