111111111111
1C0000000011
100P0000C1E1
100000C00001
111111111111