1111111111111111111
1000C000000000000E1
1000000000000000001
1000000P00000000001
100000000000000C001
10000C0000000000001
1000000000000000001
100000000C000000001
1000C0000000000C001
1111111111111111111