111111111
1P00000E1
1000C0001
111111111