1111111111111
1P00000000001
1000111000001
100C00000C001
1011101111101
10000000000E1
1111111111111