11111111111111111
100000000000000E1
1000P000000000001
11111111111111111