11111111111111111
100000000C00000E1
1000P000000000001
11111111111111111